2320;
0, 91;
0;0;0;0;0;0;0;0;3;3;3;3;3;3;2;2;2;1;2;2;2;3;2;3;3;3;3;3;3;3;3;3;3;0;3;3;3;3;3;0;3;3;3;0;3;3;3;3;0;0;3;0;0;0;0;0;3;3;2;
take product #3;
2;1;2;1;0;1;1;1;0;1;2;1;0;1;2;2;2;1;2;1;1;1;1;1;0;1;1;1;0;0;1;1;0;0;1;1;1;0;1;1;1;0;1;1;1;1;0;1;0;1;1;0;3;0;1;0;1;1;2;2;2;2;2;2;2;2;2;1;1;1;1;1;1;2;1;2;1;1;0;0;0;0;3;0;0;0;0;0;0;0;0;0;0;0;0;0;1;1;0;0;0;0;0;1;1;1;1;1;1;1;1;1;0;1;1;1;0;1;0;0;0;1;0;1;0;1;1;1;1;1;1;1;1;1;1;1;2;1;1;0;1;1;0;1;0;1;0;1;1;1;1;1;1;0;3;0;0;0;0;0;0;3;3;3;3;3;3;3;3;3;3;3;3;3;0;3;3;0;3;3;0;3;3;3;0;3;3;3;0;3;3;3;3;0;0;0;0;0;0;0;0;3;3;0;0;0;
take product #19;
0;0;3;0;0;3;0;3;0;3;3;0;3;3;0;3;3;0;3;3;3;0;3;3;3;3;0;3;3;2;3;3;3;3;3;3;3;2;3;3;3;3;3;3;3;0;3;0;3;3;3;3;3;3;2;3;3;3;3;3;3;2;2;2;2;2;2;2;3;2;2;3;3;0;0;3;3;3;3;3;3;0;0;0;0;0;0;0;0;0;1;0;1;1;0;1;1;1;1;1;0;1;1;1;1;1;1;1;1;1;0;1;0;1;1;0;0;1;1;0;1;0;0;3;3;3;0;0;0;0;0;0;0;0;0;0;0;0;0;0;0;3;3;0;0;0;1;1;1;1;1;1;1;1;1;1;1;1;1;2;2;3;
take product #24;
2;2;1;2;1;1;1;1;1;1;1;1;1;0;1;1;1;0;0;1;0;1;0;1;1;0;1;1;1;1;1;1;1;1;1;1;1;1;1;1;1;1;1;1;1;1;2;2;3;3;3;3;3;3;3;3;3;3;3;2;2;1;1;1;1;1;1;1;2;1;1;1;1;1;1;1;2;2;1;0;0;0;0;0;3;0;0;0;0;3;0;0;3;3;3;3;3;3;3;3;3;2;3;0;3;0;3;0;0;3;3;0;3;3;3;3;3;2;3;3;2;3;2;2;2;2;3;3;3;2;2;3;3;2;3;3;3;3;0;0;3;3;3;0;0;3;3;3;0;3;3;3;3;2;2;2;3;3;3;0;0;0;3;3;0;0;0;3;3;0;0;0;0;0;0;0;0;0;0;0;3;0;3;3;3;3;3;3;3;0;0;1;1;1;1;1;1;1;1;1;1;1;2;2;2;2;2;2;2;2;2;1;2;2;3;2;3;
take product #26;
1;0;0;0;0;0;0;0;0;0;0;0;0;3;3;3;3;3;3;3;3;3;3;3;3;3;3;3;3;3;3;3;3;3;3;3;3;2;2;2;2;2;2;2;2;1;1;1;1;2;2;2;2;1;1;1;1;1;1;1;1;1;1;1;1;1;1;1;1;1;2;2;1;1;2;2;2;1;1;2;2;2;1;1;1;0;0;0;1;1;1;1;2;1;1;1;2;2;1;1;1;2;2;1;1;1;1;0;1;1;0;0;1;1;1;0;0;0;0;1;0;1;1;0;1;1;1;1;2;1;1;0;0;1;0;1;0;1;0;1;1;1;1;1;1;2;1;1;1;
take product #16;
3;3;0;0;0;0;1;1;1;1;1;1;1;1;1;1;1;1;1;1;1;1;1;1;1;1;1;1;0;0;0;0;1;1;1;1;1;1;1;1;1;1;1;1;2;2;2;2;2;2;3;3;3;3;3;2;3;2;2;2;2;2;2;1;1;1;1;1;1;2;1;2;1;1;1;2;2;1;1;1;0;1;0;0;0;0;0;0;1;1;0;1;1;1;1;0;0;0;0;0;0;1;0;
take product #6;
2;3;2;2;2;2;2;2;2;1;1;1;2;2;2;2;2;2;2;2;2;2;2;2;3;2;3;3;3;3;2;2;1;1;2;2;1;1;2;1;1;1;1;1;1;1;2;2;3;2;3;3;2;2;3;3;0;3;3;2;3;3;2;3;2;3;3;3;0;3;3;0;0;0;3;3;2;2;2;2;3;3;2;2;2;2;3;2;3;3;3;2;3;3;2;3;2;2;2;2;2;3;3;3;2;2;3;3;3;3;3;3;3;3;3;3;2;2;2;2;1;1;0;0;1;1;1;1;1;1;1;1;1;1;0;0;1;1;1;0;0;0;0;0;1;0;1;1;0;1;1;1;0;1;1;1;0;0;1;1;1;1;1;1;1;1;1;1;1;0;1;1;2;1;2;1;1;2;2;3;2;3;2;2;2;2;3;2;2;2;1;1;2;2;2;3;3;2;2;1;2;2;1;2;2;3;3;2;2;1;1;1;2;2;2;3;2;2;3;3;3;0;3;
take product #4;
3;0;3;3;3;0;0;3;3;3;3;3;0;3;3;3;0;0;3;3;0;0;0;3;3;3;3;3;3;3;3;3;0;0;3;3;0;3;3;3;3;3;3;2;3;2;2;3;3;3;3;3;0;3;3;3;0;3;0;0;3;3;3;3;3;3;3;3;3;3;3;3;3;3;3;3;3;2;
take product #20;
0;1;1;1;1;1;1;1;1;1;1;1;1;1;1;1;1;1;2;2;1;2;1;1;1;2;1;1;1;1;1;0;0;1;0;1;1;1;1;1;1;2;1;1;2;2;1;1;1;1;1;1;1;1;1;2;2;1;1;1;1;0;1;0;1;0;0;1;1;1;1;1;1;2;1;1;0;1;1;2;1;2;2;1;2;2;3;3;2;2;1;1;1;2;2;2;3;2;2;2;2;1;2;2;3;3;2;2;2;3;2;2;2;1;1;2;2;2;2;2;2;2;3;3;2;3;3;2;3;3;3;2;3;3;3;3;3;3;3;3;3;2;3;3;3;3;2;3;3;3;3;2;3;2;2;2;2;2;2;2;2;3;3;0;3;0;3;3;2;3;3;3;2;3;3;3;3;0;0;1;0;0;1;0;1;0;0;3;
take product #7;
3;3;3;0;3;3;3;3;3;0;3;3;3;3;3;3;0;3;3;0;3;3;3;3;3;3;3;3;3;3;3;2;3;2;3;2;2;2;3;2;3;3;3;2;3;3;3;3;3;3;3;3;3;2;2;2;2;2;3;3;2;2;2;2;2;2;2;2;2;2;2;2;2;1;1;0;0;0;
take product #17;
2;2;2;2;1;1;2;1;1;1;1;1;0;1;1;0;0;0;0;0;0;0;3;3;3;0;3;0;3;0;0;0;0;0;0;0;1;0;1;1;1;1;1;1;1;1;1;0;0;1;0;0;0;1;0;0;1;1;1;1;1;1;1;1;2;1;1;2;2;1;1;1;1;1;2;2;3;2;2;1;2;2;2;3;3;2;2;3;3;3;3;2;2;1;2;2;2;2;2;3;2;2;3;2;2;2;1;1;1;1;0;0;0;0;0;1;1;1;1;1;1;1;1;1;1;1;1;1;1;1;1;1;1;1;1;1;0;1;0;0;1;0;1;0;1;1;0;1;1;0;1;1;1;1;1;1;1;1;1;0;1;1;0;0;1;0;1;1;0;1;0;0;1;1;1;1;1;2;2;1;1;2;2;2;2;2;2;2;2;2;2;2;2;2;2;2;2;2;2;2;2;2;2;2;2;2;2;2;
take product #1;
3;3;3;3;0;3;3;2;3;3;0;3;3;3;2;3;3;0;0;0;1;1;1;1;1;1;0;0;3;3;3;3;3;3;3;3;2;2;3;3;2;2;2;3;3;0;0;0;3;3;3;2;2;2;3;3;0;3;3;3;3;3;0;0;0;0;0;1;0;1;1;1;1;1;1;1;1;1;0;0;3;3;3;3;3;3;3;0;0;3;0;3;3;3;3;0;3;3;3;3;2;2;2;2;2;2;3;2;
take product #2;
0;3;3;2;3;3;3;2;2;3;2;2;2;3;3;3;3;3;3;3;3;3;3;3;3;0;3;3;2;3;3;3;0;3;3;2;3;3;3;3;3;3;3;3;3;3;3;3;3;3;3;3;3;0;0;0;0;0;3;0;0;0;0;0;3;0;0;0;0;0;0;0;0;0;0;0;0;0;1;1;0;0;0;0;0;0;0;0;0;0;0;0;0;0;0;3;0;3;0;3;3;0;3;3;0;3;3;3;3;0;0;0;1;0;1;1;0;0;1;1;1;1;1;1;2;2;1;1;2;2;2;1;1;2;1;1;2;2;2;2;2;2;1;1;0;0;0;0;0;0;0;1;1;1;2;2;2;2;
take product #18;
0;0;0;0;3;3;3;2;2;2;2;2;2;2;3;3;0;0;0;0;0;0;3;3;0;3;3;0;3;3;3;3;3;3;3;3;0;0;3;3;2;3;2;2;2;2;2;2;2;2;3;3;3;0;3;3;0;3;0;3;3;0;3;
take product #22;
0;3;3;3;3;3;2;3;3;3;3;2;3;3;3;0;3;2;3;3;3;2;3;2;2;2;1;2;1;2;1;1;1;1;1;0;0;0;1;0;1;0;1;1;1;1;1;2;2;3;3;3;2;3;2;3;2;2;3;2;3;2;3;3;3;3;3;3;3;3;0;3;3;3;3;3;3;3;0;0;3;0;0;0;0;3;0;0;0;1;1;0;0;0;0;3;0;0;0;3;0;0;0;0;0;0;0;0;0;0;0;0;0;1;0;0;0;1;1;1;1;1;2;2;1;1;2;2;2;2;2;1;1;0;0;0;0;0;0;1;0;0;0;
take product #27;
2;2;1;1;0;0;0;1;1;0;0;0;0;0;1;1;1;1;1;1;1;1;1;1;1;1;0;1;1;1;1;1;1;1;1;1;2;1;1;2;1;1;1;1;2;1;1;1;2;1;1;2;1;1;2;1;1;1;2;2;1;1;1;0;0;0;3;0;0;0;0;1;1;1;1;1;1;1;1;1;1;2;1;1;1;1;1;1;1;1;1;1;1;1;1;1;1;1;2;2;1;2;1;1;1;0;0;0;0;1;1;1;1;1;1;1;1;1;1;0;0;1;1;1;0;0;0;0;0;1;0;1;1;0;1;1;1;0;1;1;1;0;0;1;1;1;1;1;1;1;1;1;1;0;1;0;0;1;0;1;1;
take product #5;
