Nodes: 71
V•••V•••X•X█X•X█X•X█V•X██
•███•███•█•█•█•█•█•█•█•██
•███•███•█•█•█•█•█•█•█•██
XX█VVX█XX█X•X•X•X•X•V•V•V
█•█•█•█•████████•█•█•█•█•
VV•V█X•X████X•X█•█•█•█•█•
•███████████•███XXX█X•V█•
V•••••••••V█X•X██•████•█•
██████████•█•████•████•█•
V••••V••••V█X•X██V••••V█•
•████•███████████•████•█•
V••••V•••V█V•V█V•V••••X█•
•████████•█•█•█•█•████•█•
•█X•X█X••V█•█•█•█•████•█•
X•X█X•X██V•V█V•V█X••••X█V
