Nodes: 3759
X•X••X•••X•••••X█X██X█X██X██XX███X████X█X█████████X████X██X███X█X██X██X██X███X██X███X████X██X█X█████
•█•██•███•█████•█•██•█X••X██XX███•███XX█X•X•••X███X••••X••X•••X•X••X••X••X•••X••X•••X••••X••X•X••••X
X•XX•XX••X•••••X•XX█•█•██X•XXX••XX•X█•████•███XX█XX████████████████████████████████████████████████•
•██•██•████████•██XXX•X•XX█•████•██X•X████•████•█•███X•••••••••••••••••••••••••••••••••••••••••••••X
•██•██•█XXX█XX█•███•██•█•██X•X██•████•██XXX•X██•█XX█XX██████████████████████████████████████████████
•██•██•█XXXXXX█•███•██•█•████XX•X•X██XX█XX██•█XX██•██X•••••••••••••••••••••••••••••••••••••••••••••X
X••X••X•XXXXXX•X•X█•██•█•████XX███X••XX██•██X•X███•████████████████████████████████████████████████•
•██████████•█•█•█•█•██•█XX••XX████•███•██•███████XX██X•••••••••••••••••••••••••••••••••••••••••••••X
XX•••••••X█•█•█•█X•XX•XXXX██•█████X•X█•██•█████X•X██XX██████████████████████████████████████████████
XX███████•█•█•█•█•██•██•█•██•██XXX██•█•██•█XX██•█████X•••••••••••••••••••••••••••••••••••••••••••••X
█X••••X██•█•█•█•█•██•█XX█XX█X••XXX██•█X••XXXX█XX███████████████████████████████████████████████████•
█•████X••X•X█•█•█•██•█•███•█•███XX██•█████•█XXXX█████X•••••••••••••••••••••••••••••••••••••••••••••X
█•████•████•█•█•█•██•█•███•█•███•███•████XX█XX█X•X██XX██████████████████████████████████████████████
█X•X•XXX•X•XXX█•█XXXXXXXX•X█•███X•••X████•█XX████XX██X••XX••XX•••••••••••••••••XXXXX•••••••••••••••X
X██•█•█•█•██XX█•█XXXXXXXX█X•X•••X████XX█XX█•██████X█████XX██XX█████████████████XXXXX███████████████•
•██•█•█•█•███•█•█XXXXXXXX•X██████████XXXX█XX█████████████•█XX██████X••X██████X•XX████XXXX██████████•
•█XX█X█•█X•X█XXX█XXXXXXXX████████X•X█•█XX█X███X•X████████•█•██X••XXX██XX••X██•██•██XXXXXXX•X•••••XXX
•██████•██████•██XXXXXXXX███X•X██•█X•X██•████XX██XX███X••X█XX█•██XXX••XX██X••XX•X•XXXX█XXX█•█████XX█
X••••••X••••••X••X██X██XX██XX█X••X██████•████•████XX█████•█XX█•██XX███XX██•██XX█•█•██•█XXX█•███X█•██
███████•███████████████XX██•██•█████████•████•█████•█████X•X██•███•███XX██•██•██•█•██•█XXX█XX█XX█XXX
███████•███████X•X█X•X•X███•█XX•••X••X█XX████XX••XXX█████•█X•XXX█XX███XX••X██•█XX█•██•█•█X██XXXX██X█
█X•••••X•••••X█•█•█•█•█X•••X██•███•██•█•██XX•XX██XXXX•X██•███•█•█XXXXXXX██•██•█X██•██•█•███XXX█X███X
███████•███████•█•█•█•███████XX███•██XXXX•XX█XX•XXXXX█•██•███•█•██XXXX█•██•██XX█X█XX•X█XX██XXX██XX█•
█X•••••X•••••X█•█•█•█XX██████XX███•██XXXX█XXXXX█XXXXX█•█XX███X█XX█•██•█XX█•███•█X•XX█X•X████•████X•X
███████•███████•█•█•██XX•X███XX██XX██XXXXXXXXXXXXXXXX█XXXX████XXX•X██XXXX█X•XXXX██•██•█████XX•X██•█•
█X•••••X•••••X█•█•█•██XX█•█X•X███•███XXXXXXXXXXX█XXXXXXXXXX████•██XX█XXXX███XX█•██XX█•█XXX•X██XX█X█•
███████•███████•█•█•██XX█X•X█████•██XXXXXXXXXXXXXXXXXXX█XXX•X██•███XXX██•██XXX█•█XXX█XXXXX█████•███•
█X•••••X•••••X█•█•█•██XX█████████•██XXXXXXXXXXXXXXXX█XX█XX██XX█•███XX███X••X█•█XX█XXXXXXXX██X██•███•
███████•███████•█•█•█████████████•██XXXXXXXXXXXXXXXX•XXXXXXXXXXXX██XX███•████•████•█•████XX•XX█•██XX
█X•••••X•••••X█•█•█•█X•X••••X•••XX█XXXXXXXXXXXXXXXXX███XXXXXXXXXX███X•X█X••X█•████•█•███XXX██XXX█XX█
███████•███████•█•█•█•█•████•███•██XXXXXXXXXXXXXXXXXXXXXXXX█XXXXX███•███•██X█XX███XXX•X█XXXX██XX•X██
█X•••••X•••••X█•█•█•█•█•████•███X••XXXXXXXXXXXXXXXXXXXXXXXX•XXXXX███XX██•█████XX██XX██XXXXX███XX████
███████•███████•█•█•█•█X████XX█████XXXXXXXXXXXXXXXXXXX█XXXX█XXXXX•X██•██•█X•X██X••XX••XXXXX██XXXX•X█
X••••••X•••••••X█X•X█•██XX███•█████XXXXXXXXXXXXXXXXXXXXX█XXXXXX█•████•██•█•█XX█•███•██XXXXX██•██•█XX
█████████████████████•███•█X•X████XXXXXXXXXXXXXXXXXXXXXXXXXXXXX•XX███XX█•█•██•█•███•██XXXXX██X██•█•█
X••••••••••••••••XXXXX███XXX█•████XXXXX█XXXXX█XXXXXXXXXXXXXXXXX█XX███XX█•█•██XXX███•██XXXX██████X█•█
█████████████████XXXX█████•██X•••XX█XXX█XXXXXXXXXXXXXXX█XXXXXXXXXXX██XX█•█•██XX████•███•████X█XX██XX
X•X•X█X•X••••X██████•████XX██████•████XXXX█XXXXXXXXXXXXXXXXXXXXXXXX██XX█X•X████X•••X███•██X•X██•████
██•█•█•█•████XX█████•█XXX███X••X█•███XXXXXXXXXXXXXXXXXXXXXXXXXXXXXX██•██•██████•███████X••X████•████
██•█•█•█•████XX••XX█X•XX█X•XX██•█•████XX█XXXXXXX█XXXXXXXXXXXXXXXXXX██•██•██████•███████•████X••X••XX
██•█•█•█•██XX████•███████•█•███•█•██XX█X•XXX█XXXXXXXXXXXXXX█XXXXXXX██•██•█X••X•X•••••••X••••X██•██•█
██•█•█•█•█XXX••X█X•••••••X█X•••X█X••XX•X█XXXXXXXXXXXXXXXXXXXXXXXXXXX•X██•█•██•█████████████████•██•█
██•█•█•█XXXX███•███████████•█████████•██XXXXX█XXXXXXXXXXXXXXXXXXXXXX████•█•██•████X•X•X█████X•XXX•XX
██•█•█•█XX█X•X█X••••••••X██XX█X•X████•██XXXXXXXXXX█XXXXXXXXXXXXXXXXX████•█•██XX•••X█•█X•••••X█•█•█•█
██•█•█•█XX███•█•████████X••XX•X█•████•███XXXXXX█XXXXXXXXXXXXXXXXXXXXXXXXX█•███•█████•█████████•█•█•█
█XX█X•X█XX•••X█•███████████•██X•XX███•███XXX██XXXXXXXXXXXXXXXXXXXXXXXXXX██•███•█████•█████████•█•█X█
█•███████•█████•███████████•████XXX██•█████•███XXXXXXXXXXXXXXXXXXX█•██████X•••XX••X█•█XXXXXXX█•█•███
█•█████XXXXXXXXXXXXXXXXX███X████•██X█XX█X██X•X█XXXXXXX█•██•█XXXXXXXX██X███•███XX██•█•█XXXXXXXXX█X█XX
█•████XXXXXXXXXXXXXXXXXXX████X••X███████•██•██XXX█XXXXXXXXXXXXXXXXX███•███•███•███XXXXXXXXXXXXXX█XX█
XX███XXXXXXXXXXXXXXXXXXXXX██████•███████•██X████XX█XXXXXXXXXXXXXXXXX••X███•███•████XXXXXXXXXXX████XX
████XXXXXXXXXXXXXXXXXXXXXXX█████•███████•██████XXXXXXXXXXXXXXXXXXXXX███X••X█X•XX███XXXXXXXXXXXX██XXX
███XXXXXXXXXXXXXXXXXXXXXXXXX████•██████XX••XX••XX█XXXXXXXXXX█XXXXXXX███•████•██XX██XXXX█XXXXX█X██•█X
██XXXXXXXXXXXXXXXXXXXXXXXXXXX███X•••X███•██XX████XXXXXXXXXXXXXXXXXXX██XX████•███•██•█XX█XXXXXX█X█•██
█XXXXXXX███XXXXXXXXX███XXXXXXX██•███•███X••XX█████•█XX█XXXXXXXXXX█XX██XXX███XX██X••X████XXXXX██X•X██
█XXXXXX█████XXXXXXX█████XXXXXX██•███•███████•█XX██XX█XX██XXXXXXXX█XX██•█•█X•XXX█████████XXXXX███████
█XXXXXX█████XXXXXXX█████XXXXXX██X███•███████•█XXX█•██XX••XXXXXXXXXXXX•X•X•X████████X•X██•█XX██████XX
█XXXXXX█████XXXXXXX█████XXXXXX██████•███████X•X█X█•██████X██XXXXXXXXX█•███████X•X██•█•█XX█████████XX
█XXXXXX█████XXXXXXX█████XXXXXX██████XXXX█████████XX████████XXXXXXXX███•██████XX█XX█•█X•X██████████•█
█XXXXXX█████XXXXXXX█████XXXXXX███████XXXX██████████████████•██XXXX████X•••XX•X███•█•██████XX██X•X█•█
█XXXXXXXXXXXXXXXXXXXXXXXXXXXXX██████████•███████████████X••X███XX█████•███XX██XX█X•X███████•██•█XXXX
█XXXXXXXXXXXXXXXXXXXXXXXXXXXXX█XX█XX█XX█X•••••••••••••••X██•████•█████•████•███•█████████X•X•XX█XXX█
█XXXXXXXXXXXXXXXXXXXXXXXXXXXXX█•██•██•████████████████████XX████X•••••X████•███•█████X••XX███X██XX██
█XXXXXXXXXXXXXXXXXXXXXXXXXXXXX█•██•██•██X█X█XXX█X█X███X████•████•█████•████X•••X•••••X██XX████X•XX██
█XXXXXXXXXXXXXXXXXXXXXXXXXXXXX█X••X••X••X•X•XXX•X•XX██XX███•████•█████•█████████████████•█████•██XX█
█XXXXXXXXXXXXXXXXXXXXXXXXXXXXX█•██•██•██•█•████████•█XXX█X█X••••X••XX•X••X•X•X•X••••X••XX•••XXX••XXX
█XXXXXXXXXXXXXXXXXXXXXXXXXXXXX█•██•██•██•█X••••••X█•███•█•█████████XX█•██•█X█•█•████•██XX███XXX███•█
█XXXXXXXXXXXXXXXXXXXXXXXXXXXXX█XX█XX█XX█X•X████████•███X•X•••X██████XXXX█•██XX█•███XX█XX████XXX███•█
█XXXXXXXXXXXXXXXXXXXXXXXXXXXXX████████████X•X•X•X•XX█X•X████████X███XXX██XX██•█•███•██•████XXXXX██XX
█XXXXXXXXXXXXXXXXXXXXXXXXXXXXX██X••X••X•••X█•█X█X█X████X•••X██X█XX████XX•XXXXX█X•••X••X████•█•█•███•
█XXXXXXXXXXXXXXXXXXXXXXXXXXXXX██•██X██•█████•██████X█X█•███X••X██•█X███•███XXX█•█████████X•X█•█X•X█X
█XXXXXXXXXX███•█████XXXXXXXXXX██•█████X•X•X•XXX█X█XXXX•X███•█████•█•███•███XXX•X••••X████X███•███X██
█XXXXXXXXX████•██████XXXXXXXXX██X••X••X█X█X██XX█•█X█X██XX██X█████X•X•X█•███•███•███████████X•X•X████
█XX██•██XX██XXXXX████XX██•██XX██•██X██████████•█•██████•█████████████•█•██XX███•███X████X••X█•█X••X█
█XX██•██XX██XXXXX████XX██•██XX██•█████X███X•••X•X•X••X•X•X••••••X████X•X██•███XX██XXX███•████•████•█
█XX██X██XX██XXXXX████XX██X██XXX•X•••••X•••X███•█•█•██•███•██████•████X█•██XX██•███•█XX██X████•████X█
████████████XXXXX█████████████•███████████████•█•█•██•███•██████•█████XX████X█•██XX██•███X•••X•••X██
████████████XXXXX█████████████•█X•••••••X•X••XX█•█•██•███X••••••X•X█X•XX██XXX█•██•██XX███•███████•██
████████████XXXXX█████████████•█•███████X█X██X█XX█•██•███•██████•██████•█XXX██XX•X██•████•███████XXX
████████████XXXXX██████████XX█•█•█XX███████X████•█•██•███•██████•██████X•X████XX███XXX███X•XX•••XXX█
████████████XXXXXX█████X••X██XX█XXXXX••••••XX•X█•█•██•███•██████•████████X████•███XX█•█████XX███•█•█
XXXXXXXXXXXXX█XXXXXXX██•██XX•XX██XXXX███████X█•█X•X██X•••X██████•█X•X████████XX██XXXXX██XX•X████•█XX
XXXXXXXXXXXXX██XXXXXXX•X█X█•██•███XXXXX█X••X██•█•█•██•███•██████XXX█•██XX██X•X██XX█XXX•XXX█•█X██•██•
XXXXXXXXXXXXX███XXXXXX███X•XX█•███•██XX█•██•█XX█•█•██•███•██████XX██•█XXX█XX██X█•██•███XX██XXXX█XXXX
XXXXXXXXXXXXX███XXXXXX█████•██•███•██•██•██•██•█•█•██•███•██████•███XXX█X•X███•█•██•████•███•█XXXXX█
XXXXXXXXXXXXX██XXXXXXXX████XX█•███•██•██•██•██•█•█•██•███X••••••X██XXX████████•█•██XX███•███•██XX█XX
XXXXXXXXXXXXX█XXXXXXXXXXX███•█XXX█•██•██•██•██•█•█•██•███•██████•██X█•█████X██•█•███•███•██XXXXXXXXX
XXXXXXXXXXXXXXXXXXXXXXXXXX██X█XX██•██•██•██•██•█•█•██•███•██████•████•█X██XX••XXX█X•XX█XX•XX█XX██XXX
XXXXXXXX██XXXXXXXXXXXXXXXXX███•███•██•██•██•██•█•█•██•███•██████•██X█XXXXX████XXX•X█XXXXX█•█X█X•XXX█
XXXXXXXX███XXXXXXXXXXXXXXXX•••X•••X██X••X██X••X•X•XX•X••XXX•X•X•X██•█XX█XX██████•███XXXX█XX█•███XXXX
XXXXXXXX████XXXXXXXXXXXXXXX████████████████████████X████X█X█X█X█X█XXXXX█XXX█████•███XXXXX█XXX█XXXX██
XXXXXXXX███XXXXXXXXXXXXXXX██████████X••••••X████X█X█XX█X█X█X█X█X█X██XXX█XXX██X██XX█X█•██•██XX█XXXX██
XXXXXXXX██XXXXXXXXXXXXXXX███████XXXXX██████XXXXXXX██XX██XX•X██XX████•█XXXXX█XX••XX█XXX██X•XXXXXXXXXX
XXXXXXXXXXXXXXXXXXXXXXXX████X•••XXXXX•XXXX•XXXXXXXXXXXX█•██•██XXXX██XX█XX██XXX████XXXX██•█XXXX█XX█X█
XXXXXXXXXXXXXXXXXXXXXXX████X████•██•██XXXX███XX█X█XXXXXXX██XX•X█XXX█XX█XX███XX███X█XXXXXX██XXX██XX██
XXXXXXXXXXXXXXXXXXXXXX████XX████•██•██X██•████XX█X████XX██XXX██XXX█XXX█XX██XXX•XX███•█XX███XXX██•███
XXXXXXXXXXXXXXXXXXXXX█████•█████•██•█X███•████X███X███•███•█•██•█XXXXX█XXXXXXX█XX██XX█•████XX█XXX██X
XXXXXXXXXXXXXXXXXXXXX████XX████XX██X•X███•██XX█████X██•███•█•██•██XX██XX█XXX█XX██X█•██XX██XXXXXX███•
XXXXXXXXXXXXXXXXXXX█████XXX•••X██████████X••X██████X••X•••X█X••X██████XX██████X██X•X███X•X███XX█X••X
XXXXXXXXXXXXXXXXXXX█████████████████████████████████████████████████████████████████████████████████
XXXXXXXXXXXXXXXXXXX█████████████████████████████████████████████████████████████████████████████████
