Nodes: 71
V•••V•••V•V█V•V█V•V█V•V██
•███•███•█•█•█•█•█•█•█•██
•███•███•█•█•█•█•█•█•█•██
VV█VVV█VV█V•V•V•V•V•V•V•V
█•█•█•█•████████•█•█•█•█•
VV•V█V•V████X•X█•█•█•█•█•
•███████████•███VVV█V•V█•
V•••••••••V█X•X██•████•█•
██████████•█•████•████•█•
V••••V••••V█X•X██V••••V█•
•████•███████████•████•█•
V••••V•••V█V•V█V•V••••V█•
•████████•█•█•█•█•████•█•
•█V•V█V••V█•█•█•█•████•█•
V•V█V•V██V•V█V•V█V••••V█V
