Nodes: 71
V•••X•••X•X█X•X█X•X█X•X██
•███•███•█•█•█•█•█•█•█•██
•███•███•█•█•█•█•█•█•█•██
XX█XXX█XX█X•X•X•X•X•X•X•X
█•█•█•█•████████•█•█•█•█•
XX•X█X•X████X•X█•█•█•█•█•
•███████████•███XXX█X•X█•
X•••••••••X█X•X██•████•█•
██████████•█•████•████•█•
X••••X••••X█X•X██X••••X█•
•████•███████████•████•█•
X••••X•••X█X•X█X•X••••X█•
•████████•█•█•█•█•████•█•
•█X•X█X••X█•█•█•█•████•█•
X•X█X•X██X•X█X•X█X••••X█X
